Map Width: 21, Map Height: 21, Current Round: 15, Seed: 1135358800, PlayerBounty: 560
#####################
#   + +  +++  +    +#
# #+# # # # # # #+# #
#    + + + + + +    #
# # #+# # # # #+# # #
#  ++    +++    ++  #
# # # #+# # #+# # # #
# +   ++ + + ++   + #
#A# #+# #+#+# #+# # #
#  + ++ +++++ ++ +  #
# # # # #+$+# # # # #
#  + ++ +++++ ++ +  #
# # #+# #+#+# #+# # #
# +   ++ + + ++   + #
# # # #+# # #+# # # #
#  ++    +++    ++  #
# # #+# # # # #+# #+#
#    + + + + + +    #
# #+# # # # # # #+# #
#+    +  +++  + +  B#
#####################
---------------------------
Player Name: Player 1
Key: A
Points: 13
Status: Alive
Bombs: 
BombBag: 1
BlastRadius: 1
---------------------------
---------------------------
Player Name: John
Key: B
Points: 0
Status: Alive
Bombs: 
BombBag: 1
BlastRadius: 1
---------------------------
