Map Width: 21, Map Height: 21, Current Round: 98, Seed: 639817837, PlayerBounty: 600
#####################
#   +  + + + +    + #
# #+#+#+# # #+#+#+# #
#   ++ +     + ++   #
#+# # #+#+#+#+# # # #
# + + +++   +++ + + #
# # # # # #*# # # # #
#        *****+     #
#+# # # #A#*# # # #+#
#    +++   ++!      #
# # # # #  +# # # # #
#      +++++ B      #
#+# # # #+#*# # # #+#
#     +   ******    #
# # # # #+#*# # # # #
# + + +++   +       #
# # # #+#+#+#+# # # #
#   ++ +     +      #
# #+#+#+# # #+# # # #
# +    + + +        #
#####################
---------------------------
Player Name: Player 1
Key: A
Points: 191
Status: Alive
Bombs: 
BombBag: 2
BlastRadius: 2
---------------------------
---------------------------
Player Name: John
Key: B
Points: 241
Status: Alive
Bombs: 
BombBag: 2
BlastRadius: 4
---------------------------
