Map Width: 21, Map Height: 21, Current Round: 33, Seed: 623126043, PlayerBounty: 600
#####################
#  ++ +       + ++  #
# # # #+#+#+#+# # #+#
#   ++         ++ + #
# # # # # # # # # # #
#  +   ++   ++   +  #
# #+# # # # # # #+# #
#   + +++   +++ + + #
# # #+#+#+#+#+#+# #+#
#     +++++++++     #
#A# # #+#+$+#+# # # #
#     +++++++++     #
#+# #+#+#+#+#+#+# #+#
# + + +++   +++ + + #
# #+# # # # # # #+# #
#  +   ++   ++   *  #
# # # # # # # #B#*# #
# + ++           *  #
#+# # #+#+#+#+# # # #
#  ++ +       +     #
#####################
---------------------------
Player Name: Player 1
Key: A
Points: 44
Status: Alive
Bombs: 
BombBag: 1
BlastRadius: 1
---------------------------
---------------------------
Player Name: John
Key: B
Points: 73
Status: Alive
Bombs: 
BombBag: 1
BlastRadius: 1
---------------------------
