Map Width: 21, Map Height: 21, Current Round: 90, Seed: 639817837, PlayerBounty: 600
#####################
#   +  + + + +    + #
# #+#+#+# # #+#+#+# #
#   ++ +     + ++   #
#+# # #+#+#+#+# # # #
# + + +++   +++ + + #
# # # # # #+# # # # #
#          A  +     #
#+# # # # #+#4# # #+#
#    +++   ++*      #
# # # # #  +#*# # # #
#      +++++******  #
#+# # # #+#+#*# # #+#
#     +   +B *      #
# # # # #+#+#*# # # #
# + + +++   +*      #
# # # #+#+#+#+# # # #
#   ++ +     +      #
# #+#+#+# # #+# # # #
# +    + + +        #
#####################
---------------------------
Player Name: Player 1
Key: A
Points: 171
Status: Alive
Bombs: {x:14,y:9,fuse:4,radius:2}
BombBag: 1
BlastRadius: 2
---------------------------
---------------------------
Player Name: John
Key: B
Points: 211
Status: Alive
Bombs: 
BombBag: 2
BlastRadius: 4
---------------------------
