Map Width: 21, Map Height: 21, Current Round: 54, Seed: 623126043, PlayerBounty: 600
#####################
#  ++ +       + ++  #
# # # #+#+#+#+# # #+#
#   ++         ++ + #
# # # # # # # # # # #
#  +   ++   ++   +  #
# #+# # # # # # #+# #
#   + +++   +++ + + #
# # # #+#+#+#+#+# #+#
#     1++++++++     #
# # #A#+#+$+#+# # # #
#     +++++++++     #
#+# #+#+#+#+#+# # #+#
# + + +++   +B    + #
# #+# # # # # # #+# #
#  +   ++   +       #
# # # # # # # # # # #
# + ++              #
#+# # #+#+#+#+# # # #
#  ++ +       +     #
#####################
---------------------------
Player Name: Player 1
Key: A
Points: 67
Status: Alive
Bombs: {x:7,y:10,fuse:1,radius:1}
BombBag: 0
BlastRadius: 1
---------------------------
---------------------------
Player Name: John
Key: B
Points: 126
Status: Alive
Bombs: 
BombBag: 1
BlastRadius: 1
---------------------------
